1111111
10PC0C1
1P001E1
1111111