1111111
100001
1P001E1
1111111