1111111
1000001
1P001E1
1111111