1111111
100C0C1
1P00101
1111111