1111111
100C0C1
1P001E1
1110111