111111111111111111111111111
100100000000000000000000001
100100000000000000000000001
100100000000000000000000001
10011110000C000000000100001
100000000000000000000010001
100100000000000000000001001
10011110000C000000000000101
100100000000000000111000001
100100000000000000000000001
100100000000000000000000001
1P0011E00000000000000000001
10010000000C000010000000001
100000000000000010000000001
100000000000000010000000001
100000000000111110000000001
100000000000000000000000001
100100000000000000000000001
100100000000000000000000001
100001111100000000000000001
111111111111111111111111111