1111111
100C001
1PC01E1
1111111