111111111111111111111111111111111111111111111111111111111111111111111111111111111111111111111111111111111111111111111111111111111111111111111111111111111111111111111111111111111111111111111111111111111111111111111111111111111111111111111111111111
1000C0000C0000C0000C0000C0000C0000C0000C0000C0000C0000C0000C0000C0000C0000C0000C0000C0000C0000C000000000C0000C0000C0000C0000C0000000C0000C0000C0000C0000C0000C0000C0000C0000C0000C0000C0000C0000C0000C0000C0000C0000C0000C0000C0000C0000C0000C00000001
100000000000P000000000000000000000C00000000000000000000000000000000000001E0000000000000000000000000000000000000000CCCCC000000000000010000C0000C0000C0000C0000C0000C0000C0000C0000C0000C0000C0000C0000C0000C0000C0000C0000C0000C0000C0000C0000C00000001
111111111111111111111111111111111111111111111111111111111111111111111111111111111111111111111111111111111111111111111111111111111111111111111111111111111111111111111111111111111111111111111111111111111111111111111111111111111111111111111111111111